...........................
...........................
...........................
.....b..e.b..e............
**...********....*........
**...***************.......
....*......................
.................e..b.l....
.b.....*****...b....*******
***************************
...........................
...........................
...........................