...........................
..........e................
...........................
...........................
.........e.................
*.....................e....
*......******.......*..*...
*........e.....e....*******
*............e....**.......
*.l......**********.......
*.****************.........
*****************.....b..l.
***************************
