...........................
...........................
...e.......****.e....l.....
b......b.............******
********....e....****......
...............**..........
.............**............
l..........**..............
*........**................
***************************
...........................
...........................
...........................
